00011010000
01000000010
01111101100
10100110010
01000101000
00011111010
10110001110
00011010110
10001001110
01111011010
01011010100
00010010010
01011000100
01010111111
10010111001
01011001100
01011000100
01000001000
11100010111
00101101000
10011010011
10111000101
10101000010
10101000010